GROUP:      weka.weka.io
KIND:       WekaClient
VERSION:    v1alpha1

DESCRIPTION:
    WekaClient is the Schema for the clients API
    
FIELDS:
  apiVersion	<string>
  kind	<string>
  metadata	<ObjectMeta>
    annotations	<map[string]string>
    creationTimestamp	<string>
    deletionGracePeriodSeconds	<integer>
    deletionTimestamp	<string>
    finalizers	<[]string>
    generateName	<string>
    generation	<integer>
    labels	<map[string]string>
    managedFields	<[]ManagedFieldsEntry>
      apiVersion	<string>
      fieldsType	<string>
      fieldsV1	<FieldsV1>
      manager	<string>
      operation	<string>
      subresource	<string>
      time	<string>
    name	<string>
    namespace	<string>
    ownerReferences	<[]OwnerReference>
      apiVersion	<string> -required-
      blockOwnerDeletion	<boolean>
      controller	<boolean>
      kind	<string> -required-
      name	<string> -required-
      uid	<string> -required-
    resourceVersion	<string>
    selfLink	<string>
    uid	<string>
  spec	<Object>
    additionalMemory	<integer>
    agentPort	<integer>
    allowHotUpgrade	<boolean>
    autoRemoveTimeout	<string>
    coreIds	<[]integer>
    coresNum	<integer>
    cpuPolicy	<string>
    enum: auto, shared, dedicated, dedicated_ht, ....
    cpuRequest	<string>
    csiConfig	<Object>
      advanced	<Object>
        controllerLabels	<map[string]string>
        controllerTolerations	<[]Object>
          effect	<string>
          key	<string>
          operator	<string>
          tolerationSeconds	<integer>
          value	<string>
        enforceTrustedHttps	<boolean>
        nodeLabels	<map[string]string>
        nodeTolerations	<[]Object>
          effect	<string>
          key	<string>
          operator	<string>
          tolerationSeconds	<integer>
          value	<string>
        skipGarbageCollection	<boolean>
      csiGroup	<string>
      disableControllerCreation	<boolean>
    driversDistService	<string>
    driversLoaderImage	<string>
    globalPVC	<Object>
      name	<string> -required-
      path	<string>
    hugepages	<integer>
    hugepagesOffset	<integer>
    image	<string> -required-
    imagePullSecret	<string>
    joinIpPorts	<[]string>
    network	<Object>
      deviceSubnets	<[]string>
      ethDevice	<string>
      ethDevices	<[]string>
      gateway	<string>
      selectors	<[]Object>
        deviceNames	<[]string>
        max	<integer>
        min	<integer>
        subnet	<string>
      udpMode	<boolean>
    nodeSelector	<map[string]string>
    overrides	<Object>
      forceDrain	<boolean>
      machineIdentifierNodeRef	<string>
      skipActiveMountsCheck	<boolean>
      umountOnHost	<boolean>
    port	<integer>
    portRange	<Object>
      basePort	<integer> -required-
      portRange	<integer>
    rawTolerations	<[]Object>
      effect	<string>
      key	<string>
      operator	<string>
      tolerationSeconds	<integer>
      value	<string>
    resources	<Object>
      limits	<Object>
        cpu	<Object>
        memory	<Object>
      requests	<Object>
        cpu	<Object>
        memory	<Object>
    serviceAccountName	<string>
    targetCluster	<Object>
      name	<string> -required-
      namespace	<string> -required-
    tolerations	<[]string>
    tracesConfiguration	<Object>
      dumperConfigMode	<string>
      enum: override, partial-override, auto, cluster
      ensureFreeSpace	<integer>
      maxCapacityPerIoNode	<integer>
    upgradePolicy	<Object>
      type	<string>
      enum: manual, all-at-once, rolling, all-at-once-force
    wekaHome	<Object>
      cacertSecret	<string>
    wekaHomeConfig	<Object>
      cacertSecret	<string>
    wekaSecretRef	<string>
  status	<Object>
    conditions	<[]Object>
      lastTransitionTime	<string> -required-
      message	<string> -required-
      observedGeneration	<integer>
      reason	<string> -required-
      status	<string> -required-
      enum: True, False, Unknown
      type	<string> -required-
    lastAppliedSpec	<string>
    printer	<Object>
      containers	<string>
    stats	<Object>
      containers	<Object>
        active	<integer>
        created	<integer>
        desired	<integer>
    status	<string>
    enum: Init, Running, Upgrading, Destroying

