GROUP:      weka.weka.io
KIND:       WekaManualOperation
VERSION:    v1alpha1

DESCRIPTION:
    WekaManualOperation is the Schema for the wekamanualoperations API
    
FIELDS:
  apiVersion	<string>
  kind	<string>
  metadata	<ObjectMeta>
    annotations	<map[string]string>
    creationTimestamp	<string>
    deletionGracePeriodSeconds	<integer>
    deletionTimestamp	<string>
    finalizers	<[]string>
    generateName	<string>
    generation	<integer>
    labels	<map[string]string>
    managedFields	<[]ManagedFieldsEntry>
      apiVersion	<string>
      fieldsType	<string>
      fieldsV1	<FieldsV1>
      manager	<string>
      operation	<string>
      subresource	<string>
      time	<string>
    name	<string>
    namespace	<string>
    ownerReferences	<[]OwnerReference>
      apiVersion	<string> -required-
      blockOwnerDeletion	<boolean>
      controller	<boolean>
      kind	<string> -required-
      name	<string> -required-
      uid	<string> -required-
    resourceVersion	<string>
    selfLink	<string>
    uid	<string>
  spec	<Object>
    action	<string> -required-
    enum: sign-drives, discover-drives, force-resign-drives, block-drives, ....
    image	<string>
    imagePullSecret	<string>
    payload	<Object> -required-
      blockDrivesPayload	<Object>
        node	<string> -required-
        serialIDs	<[]string> -required-
      discoverDrivesPayload	<Object>
        nodeSelector	<map[string]string>
      ensureNICsPayload	<Object>
        dataNICsNumber	<integer>
        nodeSelector	<map[string]string>
        type	<string> -required-
      forceResignDrivesPayload	<Object>
        devicePaths	<[]string>
        deviceSerials	<[]string>
        nodeName	<string> -required-
      remoteTracesSessionPayload	<Object>
        allowHttpWekahomeEndpoint	<boolean>
        allowInsecureWekahomeEndpoint	<boolean>
        cluster	<Object>
          name	<string> -required-
          namespace	<string> -required-
        duration	<string>
        nodeSelector	<map[string]string>
        wekahomeCaSecret	<string>
        wekahomeEndpointOverride	<string>
      signDrivesPayload	<Object>
        devicePaths	<[]string>
        nodeSelector	<map[string]string>
        options	<Object>
          allowEraseNonWekaPartitions	<boolean>
          allowEraseWekaPartitions	<boolean>
          allowNonEmptyDevice	<boolean>
          skipTrimFormat	<boolean>
        pciDevices	<Object>
          deviceId	<string> -required-
          vendorId	<string> -required-
        type	<string> -required-
        enum: aws-all, gcp-all, device-identifiers, device-paths, ....
    tolerations	<[]Object>
      effect	<string>
      key	<string>
      operator	<string>
      tolerationSeconds	<integer>
      value	<string>
  status	<Object>
    completedAt	<string> -required-
    result	<string> -required-
    status	<string> -required-

